                        AKey::A();
                        BKey::B();
                        CKey::C();
                        DKey::D();
                        EKey::E();
                        FKey::F();
                        GKey::G();
                        HKey::H();
                        IKey::I();
                        JKey::J();
                        KKey::K();
                        LKey::L();
                        MKey::M();
                        NKey::N();
                        OKey::O();
                        PKey::P();
                        QKey::Q();
                        RKey::R();
                        SKey::S();
                        TKey::T();
                        UKey::U();
                        VKey::V();
                        WKey::W();
                        XKey::X();
                        YKey::Y();
                        ZKey::Z();
                        OneKey::One();
                        TwoKey::Two();
                        ThreeKey::Three();
                        FourKey::Four();
                        FiveKey::Five();
                        SixKey::Six();
                        SevenKey::Seven();
                        EightKey::Eight();
                        NineKey::Nine();
                        ZeroKey::Zero();
                        F1Key::F1();
                        F2Key::F2();
                        F3Key::F3();
                        F4Key::F4();
                        F5Key::F5();
                        F6Key::F6();
                        F7Key::F7();
                        F8Key::F8();
                        F9Key::F9();
                        F10Key::F10();
                        F11Key::F11();
                        F12Key::F12();
                        F13Key::F13();
                        F14Key::F14();
                        F15Key::F15();
                        F16Key::F16();
                        F17Key::F17();
                        F18Key::F18();
                        F19Key::F19();
                        F20Key::F20();
                        F21Key::F21();
                        F22Key::F22();
                        F23Key::F23();
                        F24Key::F24();
                        BackspaceKey::Backspace();
                        TabKey::Tab();
                        ClearKey::Clear();
                        EnterKey::Enter();
                        LeftShiftKey::LeftShift();
                        LeftControlKey::LeftControl();
                        LeftAltKey::LeftAlt();
                        RightShiftKey::RightShift();
                        RightControlKey::RightControl();
                        RightAltKey::RightAlt();
                        PauseKey::Pause();
                        CapsLockKey::CapsLock();
                        EscapeKey::Escape();
                        SpaceKey::Space();
                        PageUpKey::PageUp();
                        PageDownKey::PageDown();
                        EndKey::End();
                        HomeKey::Home();
                        LeftArrowKey::LeftArrow();
                        RightArrowKey::RightArrow();
                        UpArrowKey::UpArrow();
                        DownArrowKey::DownArrow();
                        SelectKey::Select();
                        PrintKey::Print();
                        ExecuteKey::Execute();
                        PrintScreenKey::PrintScreen();
                        InsertKey::Insert();
                        DeleteKey::Delete();
                        HelpKey::Help();
                        LeftWindowsKey::LeftWindows();
                        RightWindowsKey::RightWindows();
                        AppsKey::Apps();
                        Numpad1Key::Numpad1();
                        Numpad2Key::Numpad2();
                        Numpad3Key::Numpad3();
                        Numpad4Key::Numpad4();
                        Numpad5Key::Numpad5();
                        Numpad6Key::Numpad6();
                        Numpad7Key::Numpad7();
                        Numpad8Key::Numpad8();
                        Numpad9Key::Numpad9();
                        Numpad0Key::Numpad0();
                        SubtractKey::Subtract();
                        PeriodKey::Period();
                        ForwardSlashKey::ForwardSlash();
                        NumLockKey::NumLock();
                        ScrollLockKey::ScrollLock();
                        BrowserBackKey::BrowserBack();
                        BrowserForwardKey::BrowserForward();
                        BrowserRefreshKey::BrowserRefresh();
                        BrowserStopKey::BrowserStop();
                        BrowserSearchKey::BrowserSearch();
                        BrowserFavoritesKey::BrowserFavorites();
                        BrowserStartKey::BrowserStart();
                        VolumeMuteKey::VolumeMute();
                        VolumeDownKey::VolumeDown();
                        VolumeUpKey::VolumeUp();
                        NextTrackKey::NextTrack();
                        PreviousTrackKey::PreviousTrack();
                        StopTrackKey::StopTrack();
                        PlayPauseTrackKey::PlayPauseTrack();
                        StartMailKey::StartMail();
                        SelectMediaKey::SelectMedia();
                        StartApplication1Key::StartApplication1();
                        StartApplication2Key::StartApplication2();